 , , , , , , , , , , , , , , , , , , , , , , , , , , , , , , , , , , , , , , , , , , , , , , , , , , , , , , , , , , , , , , , , , , , , , , , , , , , , , , , , , , , , , , , , , , , , , , , , , , , , , , , , , , , , , , , , , , , , , , , , , , , , , , , , , , , , , , , , , , , , , , , , , , , , , , , , , , , , , , , , , , , , , , , , , , , , , , , , , , , , , , , , , , , , , , , , , , , , , , , , , , , , , , , ,
 , , , , , , , , , , , , , , , , , , , , , , , , , , , , , , , , , , , , , , , , , , , , , , , , , , , , , , , , , , , , , , , , , , , , , , , , , , , , , , , , , , , , , , , , , , , , , , , , , , , , , , , , , , , , , , , , , , , , , , , , , , , , , , , , , , , , , , , , , , , , , , , , , , , , , , , , , , , , , , , , , , , , , , , , , , , , , , , , , , , , , , , , , , , , , , , , , , , , ,_,o, , , , , , , , , ,
 , , , , , , , , , , , , , , , , , , , , , , , , , , , , , , , , , , , , , , , , , , , , , , , , , , , , , , , , , , , , , , , , , , , , , , , , , , , , , , , ,G, ,G, , , , , , , , , , , , , , , , , , , , , , , , , , , , , , , , , , , , , , , , , , , , , , , , , , , , , , , , , , , , , , , , , , , , , , , , , , , , , , , , , , , , , , , , , , , , , , , , , , , , , , , , , , , , , , , , , , ,\,|, , , , , , , , , ,
 , , , , , , , , , , , , , , , , , , , , , ,?, , , , , , , , , , , , , , , , , , , , , , , , , , , , , , , , , , , , , , , , , , , , , , , , , , , , , , , , , ,#,#,#,#,#,#,#,#, , , ,#,#,#,?, , , , , , , , , , , , , , ,?, , , , , , , , , , , ,#,#,#, , , , ,#,?,?,#, , , , , , , , , , , , , , , , , , , , , , , , , , , , , , , , , , , , , , , , , , , , , , , , , , , , , , , , ,T,T, , , , , , , , ,|, , , , , , , , , ,
 , , , , , , , , , , , , , , , , , , , , , , , , , , , , , , , , , , , , , , , , , , , , , , , , , , , , , , , , , , , , , , , , , , , , , , , , , , , , , , , , , , , , , , , , , , , , , , , , , , , , , , , , , , , , , , , , , , , , , , , , , , , , , , , , , , , , , , , , , , , , , , , , , , , , , , , , , , , , , , , , , , , , , , , , , , , , , , , , , , , , , , , , , , ,T,T,T, , , , , , , , ,|, , , , , , , , , ,
 , , , , , , , , , , , , , , , , , , , , , , , , , , , , , , , , , , , , , , , , , , , , , , , , , , , , , , , , , , , , , , , , , , , , , , , , , , , , , , , , , , , , , , , , , , , , , , , , , , , , , , , , , , , , , , , , , , , , , , , , , , , , , , , , , , , , , , , , , , , , , , , , , , , , , , , , , , , , , , , , , , , , , , , , , , , , , , , , , , , , , , , , , ,T,T,T,T, , , , , , , , ,|, , , , , , , , , ,
 , , , , , , , , , , , , , , , , , , , , , , , , , , , , , , , , , , , , , , , , , , , , , , , , , , , , , , , , , , , , , , , , , , , , , , , , , , , , , , , , , , , , , , , , , , , , , , , , , , , , , , , , , , , , , , , , , , , , , , , , , , , , , , , , , , , , , , , , , , , , , , , , , , , , , , , , , , , , , , , , , , , , , , , , , , , , , , , , , , , , , , , , ,T,T,T,T,T, , , , , , , , ,|, , , , ,[,=,], , ,
 , , , , , , , , , , , , , , , ,?, , , ,#,?,#,?,#, , , , , , , , , , , , , , , , , , , , , ,[,], , , , , , , , , ,[,], , , , , , , , , , , , , , , , , , ,#,?,#, , , , , , , , , , , , , , ,#, , , , , ,#,#, , , , ,?, , ,?, , ,?, , , , , ,#, , , , , , , , , , ,#,#, , , , , , ,T, , ,T, , , , , , , , , , ,T,T, , ,T, , , , , , , , , , , , ,#,#,?,#, , , , , , , , , , , , ,T,T,T,T,T,T, , , , , , , , ,|, , , , ,[,=,], , ,
 , , , , , , , , , , , , , , , , , , , , , , , , , , , , , , , , , , , , , ,[,], , , , , , ,|,|, , , , , , , , , ,|,|, , , , , , , , , , , , , , , , , , , , , , , , , , , , , , , , , , , , , , , , , , , , , , , , , , , , , , , , , , , , , , , , , , , , , , , , , , , , , ,T,T, , ,T,T, , , , , , , , ,T,T,T, , ,T,T, , , , , , , , , , , , , , , , , , , , , , , , , , ,T,T,T,T,T,T,T, , , , , , , , ,|, , , ,[,=,=,=,], ,
 , , , , , , , , , , , , , , , , , , , , , , , , , , , ,[,], , , , , , , , ,|,|, , , , , , ,|,|, , , , , , , , , ,|,|, , , , , , , , , , , , , , , , , , , , , , , , , , , , , , , , , , , , , , , , , , , , , , , , , , , , , , , , , , , , , , , , , , , , , , , , , , , , ,T,T,T, , ,T,T,T, , , , , , ,T,T,T,T, , ,T,T,T, , , , , ,[,], , , , , , , , , , , , , , ,[,], ,T,T,T,T,T,T,T,T, , , , , , , , ,|, , , ,[,=, ,=,], ,
 , , , , , , , , , , , , , , , , , , , , , ,G, , , , , ,|,|, , , , , , , , ,|,|,G, , , , , ,|,|, , , ,G,G, , , , ,|,|, , , , , , , , , , , , , , , , , , , , , , , , , , , , , , , , , , , , , , ,G, ,G, , , , , , , ,K, , , , , , ,G, ,G, , , , , , , ,G,G, ,G,G, , , , , ,T,T,T,T, , ,T,T,T,T, , , , ,T,T,T,T,T, , ,T,T,T,T, , , , ,|,|, , , , , , , , , ,G, ,G, , ,|,|,T,T,T,T,T,T,T,T,T, , , , , , , , ,#, , , ,[,=, ,=,], ,
#,#,#,#,#,#,#,#,#,#,#,#,#,#,#,#,#,#,#,#,#,#,#,#,#,#,#,#,#,#,#,#,#,#,#,#,#,#,#,#,#,#,#,#,#,#,#,#,#,#,#,#,#,#,#,#,#,#,#,#,#,#,#,#,#,#,#,#,#, , ,#,#,#,#,#,#,#,#,#,#,#,#,#,#,#, , , ,#,#,#,#,#,#,#,#,#,#,#,#,#,#,#,#,#,#,#,#,#,#,#,#,#,#,#,#,#,#,#,#,#,#,#,#,#,#,#,#,#,#,#,#,#,#,#,#,#,#,#,#,#,#,#,#,#,#,#,#,#,#,#,#, , ,#,#,#,#,#,#,#,#,#,#,#,#,#,#,#,#,#,#,#,#,#,#,#,#,#,#,#,#,#,#,#,#,#,#,#,#,#,#,#,#,#,#,#,#,#,#,#,#,#,#,#,#,#,
#,#,#,#,#,#,#,#,#,#,#,#,#,#,#,#,#,#,#,#,#,#,#,#,#,#,#,#,#,#,#,#,#,#,#,#,#,#,#,#,#,#,#,#,#,#,#,#,#,#,#,#,#,#,#,#,#,#,#,#,#,#,#,#,#,#,#,#,#, , ,#,#,#,#,#,#,#,#,#,#,#,#,#,#,#, , , ,#,#,#,#,#,#,#,#,#,#,#,#,#,#,#,#,#,#,#,#,#,#,#,#,#,#,#,#,#,#,#,#,#,#,#,#,#,#,#,#,#,#,#,#,#,#,#,#,#,#,#,#,#,#,#,#,#,#,#,#,#,#,#,#, , ,#,#,#,#,#,#,#,#,#,#,#,#,#,#,#,#,#,#,#,#,#,#,#,#,#,#,#,#,#,#,#,#,#,#,#,#,#,#,#,#,#,#,#,#,#,#,#,#,#,#,#,#,#,